10 8
##########
#O....#..#
#.######.#
#.#......#
#...#.##.#
#.###..#.#
#...#..#C#
##########
