21 21
#####################
#O#.......#.......#.#
#.#.#####.#.#####.#.#
#.#...#...#.#...#.#.#
#.###.#.###.###.#.#.#
#...#.#...#...#.....#
###.#.#.#.###.#######
#.#.#.#.#.....#...#.#
#.#.#.#.#######.#.#.#
#.#...#.......#.#...#
#.#######.###.#.#####
#.........#...#...#.#
#.#########.#####.#.#
#.#...#.....#...#...#
#.###.#.#####.#.###.#
#.....#.....#.#.#...#
###########.#.#.###.#
#.........#...#....C#
#.#########.#########
#...................#
#####################
